異口同音	いくどうおん		
一衣帯水	いちいたいすい		
一言居士	いちげんこじ		
一念発起	いちねんほっき		
一部始終	いちぶしじゅう		
一蓮托生	いちれんたくしょう		
一石二鳥	いっせきにちょう		
右往左往	うおうさおう		
運転免許	うんてんめんきょ		
遠隔操作	えんかくそうさ		
横断歩道	おうだんほどう		
大風呂敷	おおぶろしき		
岡目八目	おかめはちもく		
快刀乱麻	かいとうらんま		
街頭録音	がいとうろくおん		
火気厳禁	かきげんきん		
奇想天外	きそうてんがい		
喜怒哀楽	きどあいらく		
金城鉄壁	きんじょうてっぺき		
空前絶後	くうぜんぜつご		
古今東西	ここんとうざい		
五臓六腑	ごぞうろっぷ		
誇大妄想	こだいもうそう		
小春日和	こはるびより		
木端微塵	こっぱみじん		
五分五分	ごぶごぶ		
賛否両論	さんぴりょうろん		
三位一体	さんみいったい		
自給自足	じきゅうじそく		
時限爆弾	じげんばくだん		
試行錯誤	しこうさくご		
自業自得	じごうじとく		
子々孫々	ししそんそん		
四捨五入	ししゃごにゅう		
十中八九	じっちゅうはっく		
士農工商	しのうこうしょう		
杓子定規	しゃくしじょうぎ		
余裕綽々	よゆうしゃくしゃく		
弱肉強食	じゃくにくきょうしょく		
島国根性	しまぐにこんじょう		
針小棒大	しんしょうぼうだい		
私有財産	しゆうざいさん		
収支決算	しゅうしけっさん		
集積回路	しゅうせきかいろ		
取捨選択	しゅしゃせんたく		
首尾一貫	しゅびいっかん		
雨天順延	うてんじゅんえん		
春夏秋冬	しゅんかしゅうとう		
正真正銘	しょうしんしょうめい		
順風満帆	じゅんぷうまんぱん		
面会謝絶	めんかいしゃぜつ		
伸縮自在	しんしゅくじざい		
清廉潔白	せいれんけっぱく		
和洋折衷	わようせっちゅう		
正々堂々	せいせいどうどう		
千客万来	せんきゃくばんらい		
千差万別	せんさばんべつ		
潜在意識	せんざいいしき		
前代未聞	ぜんだいみもん		
大器晩成	たいきばんせい		
先祖代々	せんぞだいだい		
他言無用	たごんむよう		
多種多様	たしゅたよう		
他力本願	たりきほんがん		
断崖絶壁	だんがいぜっぺき		
中途半端	ちゅうとはんぱ		
地盤沈下	じばんちんか		
追突事故	ついとつじこ		
津々浦々	つつうらうら		
徹頭徹尾	てっとうてつび		
原爆投下	げんばくとうか		
物価騰貴	ぶっかとうき		
投身自殺	とうしんじさつ		
途中下車	とちゅうげしゃ		
日光消毒	にっこうしょうどく		
日進月歩	にっしんげっぽ		
難行苦行	なんぎょうくぎょう		
二束三文	にそくさんもん		
入水自殺	にゅうすいじさつ		
年中行事	ねんちゅうぎょうじ		
純粋培養	じゅんすいばいよう		
廃物利用	はいぶつりよう		
売名行為	ばいめいこうい		
薄利多売	はくりたばい		
原八文目	はらはちぶんめ		
波乱万丈	はらんばんじょう		
元気溌剌	げんきはつらつ		
半信半疑	はんしんはんぎ		
反復練習	はんぷくれんしゅう		
品質保証	ひんしつほしょう		
風光明媚	ふうこうめいび		
服毒自殺	ふくどくじさつ		
富国強兵	ふこくきょうへい		
不承不承	ふしょうぶしょう		
不正乗車	ふせいじょうしゃ		
不偏不党	ふへんふとう		
不眠不休	ふみんふきゅう		
分譲住宅	ぶんじょうじゅうたく		
弊衣破帽	へいいはぼう		
暴飲暴食	ぼういんぼうしょく		
傍若無人	ぼうじゃくぶじん		
三日坊主	みっかぼうず		
過剰包装	かじょうほうそう		
北斗七星	ほくとしちせい		
無茶苦茶	むちゃくちゃ		
名所旧跡	めいしょきゅうせき		
自暴自棄	じぼうじき		
優遇措置	ゆうぐうそち		
有形無形	ゆうけいむけい		
優柔不断	ゆうじゅうふだん		
郵便為替	ゆうびんかわせ		
有機水銀	ゆうきすいぎん		
油断大敵	ゆだんたいてき		
前途洋洋	ぜんとようよう		
予防注射	よぼうちゅうしゃ		
一件落着	いちけんらくちゃく		
立身出世	りっしんしゅっせ		
立体交叉	りったいこうさ		
流言飛語	りゅうげんひご		
臨機応変	りんきおうへん		
臨時休業	りんじきゅうぎょう		
老若男女	ろうにゃくなんにょ		
臨床実験	りんしょうじっけん		