源氏物語	げんじものがたり
栄華物語	None
大鏡	おおかがみ
今昔物語集	こんじゃくものがたりしゅう
土佐日記	None
蜻蛉日記	かげろうにっき
和泉式部日記	None
紫式部日記	むらさきしきぶにっき
更級日記	さらしなにっき
千載集	None
枕草子	None
日本霊異記	にほんりょういき
中世の文学	None
新古今和歌集	しんこきんわかしゅう
方丈記	None
徒然草	None
隠者文学双璧	None
日本古典文学の双璧	None
保元物語	ほうげんものがたり
平治物語	へいじものがたり
平家物語	None